# Syntax Colouring Map For M5ANGLE8

# Data types (KEYWORD1)
M5ANGLE8	KEYWORD1


# Methods and Functions (KEYWORD2)
begin	KEYWORD2
isConnected	KEYWORD2
setAddress	KEYWORD2
getAddress	KEYWORD2
getVersion	KEYWORD2

analogRead	KEYWORD2
setReverse	KEYWORD2
getReverse	KEYWORD2
selectorRead	KEYWORD2

inputSwitch	KEYWORD2

writeRGB	KEYWORD2
setAll	KEYWORD2
allOff	KEYWORD2
writeBrightness	KEYWORD2


# Constants (LITERAL1)
M5ANGLE8_LIB_VERSION	LITERAL1

M5ANGLE8_DEFAULT_ADDRESS	LITERAL1
